5.29523 8.77941 13.4086 0 0 
00000000000000000000000000000000000000
00000000000000000000000000000000000000
00001111111111111111111111111111110000
00001000001010000001000000000000010000
00001010100010010000010111101111010000
00001004000010011110010100100001010000
00001010100000010010010100111101010000
00001000001110010010100000000001010000
00001010000000000010000101111111010000
00001010000000000010100100000000010000
00001000111111111010000111111001110000
00001000000000001010100100000000010000
00001111101111001010000100000111110000
00001000000001000000100101110000010000
00001000111111111111001000100010010000
00001000000000000000000000100000010000
00001011001100011010110101100110010000
00001010010000000010000002000000010000
00001000000000111011111110103011010000
00001011111110100010001000100000010000
00001000000010001000100010010000010000
00001111111111111111111111111111110000
00000000000000000000000000000000000000
00000000000000000000000000000000000000
17 25 18 28 0